15111111111111111111
12112221211122221111
12112111212221211211
12222222212111211211
11111211212122212221
11211221212121212111
12211121222121212211
11222221111121112111
12211121222221222221
11212121121111211121
12212221221222212121
12112111121212112111
12122221122212222111
12121122111111112221
12111111112122212121
12222222222121222121
12121111211121212111
11122221221121112211
12221121122222211221
11111111111111111111
