151111111111
121222212221
121111212111
121222212121
121211112121
122222222121
121112122221
122212121221
111222121121
121121122121
122222222221
111111111111
